1,1,1,1,1,1,1,1,1,1,1,1,1,1,1,1,1,1,1,1,1,1,1,1,1
1,1,1,1,1,1,1,1,1,1,1,1,1,1,1,1,1,1,1,1,1,1,1,1,1
-2,3,3,3,3,3,3,3,3,3,3,3,3,3,1,1,1,1,1,1,1,1,1,1,1
-2,2,2,2,2,2,2,2,2,2,2,2,2,3,3,3,3,1,1,1,1,1,1,1,1
-2,3,3,3,3,3,3,3,2,2,2,2,2,2,2,2,3,3,1,1,1,1,1,1,1
5,5,5,5,5,5,5,3,2,2,2,2,2,2,2,2,2,3,3,3,3,1,1,1,1
1,1,1,1,5,5,5,3,2,2,3,3,3,3,2,2,3,3,3,7,3,3,1,1,1
1,5,5,5,5,5,5,3,2,2,3,5,1,3,3,3,3,3,3,7,7,3,3,5,1
1,1,5,5,5,5,5,3,2,2,3,1,1,1,1,1,3,3,2,2,2,2,3,3,3
1,1,1,1,1,1,1,3,2,2,3,1,1,1,1,1,3,3,2,2,2,2,2,2,-4
5,5,1,1,1,1,1,3,2,2,3,1,1,1,1,1,1,3,3,3,2,2,2,2,-4
1,1,1,5,5,1,5,3,2,2,3,1,1,1,1,1,1,1,1,3,3,3,3,3,3
1,1,1,5,5,1,5,5,2,2,5,1,1,1,1,1,1,1,1,1,1,1,1,1,1
1,1,1,1,1,1,5,5,2,2,5,1,1,1,1,1,1,1,1,1,1,1,1,1,1
4,4,4,4,4,4,4,5,2,2,5,4,4,1,1,1,1,1,1,1,1,1,1,1,1
4,4,4,4,4,4,4,5,2,2,5,4,4,4,4,4,4,1,1,1,1,1,1,1,1
4,4,4,4,4,4,4,5,2,2,5,4,4,4,4,4,4,4,4,1,1,1,1,1,1
4,4,4,4,4,4,4,5,2,2,5,4,4,4,4,4,4,4,4,4,1,1,1,1,1
4,4,4,4,4,4,4,5,2,2,5,4,4,4,4,4,4,4,4,4,4,4,4,4,1
4,4,4,4,4,4,4,5,2,2,5,4,4,4,4,4,4,4,4,4,4,4,4,4,4
4,4,4,4,4,4,4,5,2,2,5,4,4,4,4,4,4,4,4,4,4,4,4,4,4
1,1,1,1,1,1,1,5,5,2,5,1,1,1,4,4,4,4,4,4,4,4,4,4,4
1,1,1,1,1,1,1,5,5,2,3,1,1,1,1,1,1,4,4,4,4,4,4,4,4
1,1,1,1,1,1,5,8,8,2,3,1,1,1,1,1,1,1,1,4,4,4,4,4,4
1,1,1,1,1,1,1,3,-6,-6,3,1,1,1,1,1,1,1,1,1,1,1,4,4,4
CrossRoad1,,,,,,,,,,,,,,,,,,,,,,,,