1,1,1,1,1,1,1,1,1,5,3,7,3,5,1,1,1,1,1,1,1,1,1,1,1
1,5,5,5,5,5,5,1,1,5,3,7,3,5,1,1,5,5,5,5,5,5,5,5,5
1,5,5,5,5,5,5,1,1,1,3,7,3,1,1,1,5,3,3,3,5,5,5,5,5
1,5,5,5,5,5,5,1,1,1,3,7,3,1,1,1,5,3,2,2,5,5,5,5,5
1,5,5,5,5,5,5,1,1,1,3,7,3,1,1,1,5,3,2,2,5,5,5,5,5
1,5,5,5,5,5,5,1,1,5,3,7,3,1,1,1,5,3,3,3,3,3,3,3,3
1,5,5,5,5,5,5,1,1,5,3,7,3,5,1,1,5,5,1,1,1,1,1,1,5
3,3,3,-5,-5,3,5,5,3,3,3,7,3,5,1,1,1,1,1,1,1,1,1,1,5
7,7,7,7,7,7,5,5,7,7,7,7,3,3,3,3,3,3,3,3,3,3,3,3,3
3,3,5,3,3,3,8,8,3,3,3,7,7,7,7,7,7,7,7,7,7,7,7,7,7
1,1,5,3,3,1,1,1,1,1,3,7,3,5,3,3,3,3,3,3,3,3,3,3,5
1,1,1,3,3,5,5,5,5,5,3,7,3,5,1,1,5,5,5,1,1,1,1,1,5
1,1,1,3,3,5,5,5,5,5,3,7,3,1,5,5,5,1,5,5,5,1,1,1,1
1,1,1,3,3,1,1,1,1,1,3,7,3,1,5,1,1,1,1,1,5,5,5,5,1
1,1,1,3,3,1,1,1,1,1,3,7,3,1,5,1,1,1,1,1,1,1,1,5,1
1,1,1,3,3,3,3,3,3,3,3,7,3,1,5,1,1,1,1,1,1,1,1,5,1
1,1,1,3,3,7,7,7,7,7,7,7,3,1,5,5,5,1,5,5,5,5,1,5,1
5,1,1,3,3,3,3,3,3,3,3,7,3,5,1,1,5,5,5,1,1,5,5,5,5
5,1,1,3,3,1,1,1,1,1,3,7,3,5,1,1,1,1,1,1,1,1,1,1,5
3,3,3,3,3,3,3,3,3,3,3,7,3,3,3,3,3,3,3,3,3,3,3,3,3
-1,7,7,7,7,7,7,7,7,7,7,7,7,7,7,7,7,7,7,7,7,7,7,7,7
-1,7,7,7,7,7,7,7,7,7,7,7,7,7,7,7,7,7,7,7,7,7,7,7,7
5,3,3,3,3,3,3,3,3,3,3,3,3,3,3,3,3,3,3,3,3,3,3,3,5
5,1,1,1,1,1,1,1,1,1,1,1,1,1,1,1,1,1,1,1,1,1,1,1,5
1,1,1,1,1,1,1,1,1,1,1,1,1,1,1,1,1,1,1,1,1,1,1,1,1
TownOutdoor,,,,,,,,,,,,,,,,,,,,,,,,