5,5,5,5,5,5,5,5,5,5,5,5,5,5,5,5,5,5,5,5,5,5,5,5,5
5,5,5,5,5,5,5,5,5,5,5,5,5,5,5,5,5,5,5,5,5,5,5,5,5
5,5,5,5,5,5,5,5,5,5,5,5,5,5,5,5,5,5,5,5,5,5,5,5,5
5,5,5,5,5,5,5,5,5,5,5,5,5,5,5,5,5,5,5,5,5,5,5,5,5
5,5,5,5,5,5,5,5,5,5,5,5,5,5,5,5,5,5,5,5,5,5,5,5,5
5,5,5,5,5,5,5,5,5,5,5,5,5,5,5,5,5,5,5,5,5,5,5,5,5
5,5,5,5,5,2,2,2,5,5,5,5,5,2,2,5,5,5,5,5,5,5,5,5,5
5,5,5,5,5,2,2,2,6,2,2,2,2,2,2,2,2,5,5,5,5,5,5,5,5
5,5,5,5,5,2,2,2,2,2,2,2,2,2,2,2,2,2,2,2,5,5,5,5,5
5,5,5,5,5,2,2,2,2,2,2,2,2,2,2,2,2,2,2,2,5,5,5,5,5
5,5,5,5,5,2,2,2,2,2,2,2,2,2,2,2,2,2,2,2,2,5,5,5,5
5,5,5,5,5,2,2,2,2,2,2,2,2,2,2,2,2,2,2,2,2,5,5,5,5
5,5,5,5,5,5,5,5,5,5,5,5,5,5,5,2,2,2,5,5,5,5,5,5,5
5,5,5,5,5,5,5,5,5,5,5,5,5,5,5,2,2,2,5,5,5,5,5,5,5
5,5,5,5,5,5,5,5,5,5,5,5,5,5,5,2,2,2,5,5,5,5,5,5,5
5,5,5,5,5,5,5,5,2,2,2,2,2,2,2,2,2,2,2,2,5,5,5,5,5
5,5,5,5,2,2,2,2,2,5,10,2,2,2,2,2,2,2,2,2,2,5,5,5,5
5,5,5,5,2,2,2,2,2,5,10,2,2,2,2,2,2,2,2,2,5,5,5,5,5
5,5,5,5,5,5,5,5,5,5,10,2,2,2,-4,-4,-4,-4,2,2,5,5,5,5,5
5,5,5,5,5,5,5,5,5,5,5,5,5,5,5,5,5,5,5,5,5,5,5,5,5
5,5,5,5,5,5,5,5,5,5,5,5,5,5,5,5,5,5,5,5,5,5,5,5,5
5,5,5,5,5,5,5,5,5,5,5,5,5,5,5,5,5,5,5,5,5,5,5,5,5
5,5,5,5,5,5,5,5,5,5,5,5,5,5,5,5,5,5,5,5,5,5,5,5,5
5,5,5,5,5,5,5,5,5,5,5,5,5,5,5,5,5,5,5,5,5,5,5,5,5
5,5,5,5,5,5,5,5,5,5,5,5,5,5,5,5,5,5,5,5,5,5,5,5,5
Arcade,DuckGame,7,8,,,,,,,,,,,,,,,,,,,,,